20 20
####################
#o................o#
#.####.#.##.#.####.#
#.#....#.##.#....#.#
#.#.#.##.##.##.#.#.#
#...#..........#...#
#.###.########.###.#
#....          ....#
#.### ###  ### ###.#
 ...# # RPBO # #...
 .#.. ######## ..#.
#.###     {    ###.#
#.....#......#.....#
#.###.#.####.#.###.#
#...#..........#...#
#.#.#.##.##.##.#.#.#
#.#....#....#....#.#
#.####.#.##.#.####.#
#o.....#....#.....o#
####################