####################
#o................o#
#.####.######.####.#
#.#..............#.#
#.#.#.########.#.#.#
#.#.#..........#.#.#
#.# #.########.#.#.#
#....          ....#
####. ###  ### .####
 .... # MMMM # ....
 .... ######## ....
####.     {    .####
#.....#......#.....#
#.#.#.###..###.#.#.#
#.#.#..........#.#.#
#.#.#.########.#.#.#
#.#..............#.#
#.####.######.####.#
#o................o#
####################