####################
#..................#
#..o............o..#
#..................#
#........oo........#
#..................#
#..................#
#.....        .....#
#.....###  ###.....#
 ..o..# MMMM #..o..
 .....########.....
#.....    {   .....#
#..................#
#..................#
#..................#
#........oo........#
#..................#
#..o............o..#
#..................#
####################